111111111111
1P0000000001
110111111101
1E00000001C1
111111111111