111111111111
1P000000CCC1
1CCC00001111
11110000CCC1
1CCC00001111
11110000CCC1
1CCC0000CCE1
111111111111