1111111111
10CCC00001
100CCC0001
1000CCC001
10000CCC01
100000CCC1
100000CCC1
10000CCC01
1000CCC001
100CCC0001
1PCCC000E1
1111111111