111111111111111111111
1E0000000000000000001
1C00000000000000000P1
111111111111111111111