111111111111111111
1P0000000000000001
101111110011111101
1E00000000000000C1
111111111111111111