11111111111
10000000001
100CCCCCP01
100C00000E1
100C0000001
100CCCCCCC1
11111111111