11111111111111111111
10P0C0000000000000E1
10000000000000000001
10000000000000000001
100000C00000C0000001
1000C00000C000000001
100C000C0000C00C0001
11111111111111111111